#########################
#                  y    #
#Y                 y   $#
#yyyyyyyy          ######
#                       #
#         ###           #
#                ###    #
#                       #
#            ###        #
#                       #
#    ###                #
#                       #
#           ###         #
#                       #
#       ###             #
#                       #
#   ###                 #
# @                     #
#########################