#########################
#          ggg          #
#    ####  g$g  ####    #
#        r ggg r        #
#        r     r        #
##        ######        #
#           g           #
#           g           #
#####       g           #
#           g           #
#       ####g           #
#           g           #
#####       g           #
#           g           #
#       ####g           #
#           gG          #
#y#######################
# @                    Y#
#########################