#########################
#        r y$y p        #
#        r yyy p        #
# r     rrrrrppp        #
#Gr                    R#
# r    #         #   g  #
#                    g  #
#   r     #####      g  #
#                    g  #
##########     ##########
#P#                   #Y#
#g #       r #       # r#
#   #     #   r     #   #
#p   #             #   p#
#     #           #     #
#                       #
#   ################    #
# @                     #
#########################