#########################
#    g              #   #
#    #             G#  R#
#    #            ###pp##
#   P#              #yy##
#y####p##           ##  #
#      #  #             #
#      # p             ##
##     #                #
#Y     #                #
##     ###        #     #
####                   p#
####                    #
#  #                    #
# $#    g           y   #
#r##                    #
#                       #
# @   #                 #
#########################